111111111111111111111111111111111
100000100000000000000000000000001
100000100000000000000000000000001
100000100000000000000000000000001
100000100011000000000000001100001
100000100001000000000000001000001
100000011111000000000000000000001
10000000000000000000P000000000001
100000000000000000000000000000001
100000000000000100000000000110001
100000000000000100000000000000001
100000000000000100000000000000001
100000000001111111111000000000001
110000000000000000000000000000001
111111100000000000000011111110101
110000000000000000000010000000001
100000000000000000000000000000011
111111111111111111111111111111111