11111111
10100001
10100001
10100001
10000001
110P0101
10000001
11111111